#################
#.......X.......#
#.XX.XXPXPXX.XX.#
#.......XPP.....#
#.XX.X...P.X.XX.#
#....X.XXX.X....#
#XXX.X..X..X.XXX#
#XXX.XX.X.XX.XXX#
#XXX.X..X..X.XXX#
#...............#
#XXX.X..G..X.XXX#
#XXX.X.....X.XXX#
#XXX.X.XXX.X.XXX#
#.......X.PPPPPP#
#.XX.XX.X.XXPXXP#
#..X....S.PPPXPP#
#X.X..XXXXXPPXPX#
#X.X..PPXPPPPXPX#
#P...XPPXPPXPPPP#
#PXXXXXPXPXXXXXP#
#PPPPPPPPPPPPPPP#
#################
