#################
#PPPPPPPXPPPPPPP#
#PXXPXXPXPXXPXXP#
#HPPPPPPXPPPPPPH#
#PXXPXPPPPPXPXXP#
#PPPPXPXXXPXPPPP#
#XXXPXPPXPPXPXXX#
#XXXPXXPXPXXPXXX#
#XXXPXPPXPPXPXXX#
#1PPPPPPPPPPPPP1#
#XXXPXPPGPPXPXXX#
#XXXPXPPPPPXPXXX#
#XXXPXPXXXPXPXXX#
#PPPPPPPXPPPPPPP#
#PXXPXXPXPXXPXXP#
#HPXPPPPSPPPPXPH#
#XPXPPXXXXXPPXPX#
#XPXPPPPXPPPPXPX#
#PPPPXPPXPPXPPPP#
#PXXXXXPXPXXXXXP#
#PPPPPPPPPPPPPPP#
#################
