#################
#PPPPPPP#PPPPPPP#
#.##P##P#P##P##P#
#HPPPPPP#PPPPPPH#
#P##P#PPPPS#.##P#
#PPP#HP###P#PPPP#
####P#PPGPP#P####
####PH#P#P##P####
#####HP.#PP#P####
#.PPPHPPPP.PPPP.#
####HHP..PP.P####
####PHPPPPP#P####
####PHP###P#P####
#PPP#PPP#PPPPPPP#
#P##P##P#P##P##P#
#HP#PP1P.PP1P#PH#
##P#PP#####PP#P##
##P#PPPP#PPPP#P##
#PPPP#PP#PP#PPPP#
#P#####P#P#####P#
#PPPPPPPPPPPPPPP#
#################
