#################
#PPPPPPP#PPPPPPP#
#P##P##P#P##P##P#
#H#PPPPP#PPPPPPH#
#P##P#PPPPP#P##P#
#PPPP#P###P.PPPP#
####H#PG#PP#P####
######..#P1#P####
####H#1P#.P#P####
#.PPH.PPPPPPPPP.#
####H#PP..P.P####
######.PPPP#P####
####H#P#.#P.P####
#PPPPPPP#PPPPPPP#
#P##P##P.P##P##P#
#HP#PPPP.PPPP#PH#
##P#PP#S###PP#P##
##P#PPPP#PPPP#P##
#PPPP#PP#PP#PPPP#
#P#####P#P#####P#
#PPPPPPPPPPPPPPP#
#################
