#################
#PPPPPPP#PPPPPPP#
#P##P##P#P##P##P#
#HPPPPPP#PSPPPPH#
#P##P#PPPPP#P##P#
#PPP#.P###P#PPPP#
####PHPG#PP#1####
#####H#P#P##P####
#####HP.#P.#P####
#.PP#HPPPPPPPPP.#
#####PP..P.#P####
####PPPPPPP#P####
######P###P#P####
#PPP1PPP#PPPPPPP#
#P##P##P#P##P##P#
#HP#PPP..PPPP#PH#
##P#PP#####PP#P##
##P#PPPP#PPPP#P##
#PPPP#PP#PP#PPPP#
#P#####P#P#####P#
#PPPPPPPPPPPPPPP#
#################
