#################
#PPPPPPP#PPPPPPP#
#P##P##P#P##P##P#
#HPPPPPP#PPPPPPH#
#P##PPPPGPPPP##P#
#PPPPPPPPPPPPPPP#
####P#PPPPP#P####
####P#PPPPP#P####
####P#PPPPP#P####
#1PPP#PPPPP#PPP1#
####P#PPPPP#P####
####P#PPPPP#P####
####P#PPPPP#P####
#PPPPPPPPPPPPPPP#
#P##P#######P##P#
#HP#PPP#S#PPP#PH#
##P#PP#####PP#P##
##P#PPPP#PPPP#P##
#PPPP#PP#PP#PPPP#
#P#####P#P#####P#
#PPPPPPPPPPPPPPP#
#################
1
5
