#################
#PPPPPPP#PPPPPPP#
#P##P##P#P##P##P#
#HPPPPPP#PPPPPPH#
#P##PHPPPPP#P##P#
#PPPPHP###P#PPPP#
####PHPP#PP#P####
####PHHP#P##P####
####PHPP#PP#P####
#1PPPPPPPPPPPPP1#
####P#PPGPP#P####
####P#PPPPP#P####
####P#P###P#P####
#PPPPPPP#PPPPPPP#
#P##P##P#P##P##P#
#HP#PPPPSPPPP#PH#
##P#PP#####PP#P##
##P#PPPP#PPPP#P##
#PPPP#PP#PP#PPPP#
#P#####P#P#####P#
#PPPPPPPPPPPPPPP#
#################
