#################
#PPPPPPP#PPPPPPP#
#P##P##P#P##P##P#
#HPPPPPP#PPPPPPH#
#P##PPPP.PPPP##P#
#PPPPPPPPPPPPPPP#
####P#PPPPP#P####
####P#PPPPP#P####
####P#PPPGP#P####
#OPPP#PPPPP#PPPO#
####P#PPPPP#P####
####P#PPPPP#P####
####P#PPPPP#P####
#PPPPPPPPPPPPPPP#
#P##P##PPP##P##P#
#HP#PPPPSPPPP#PH#
##P#PP#####PP#P##
##P#PPPP#PPPP#P##
#PPPP#PP#PP#PPPP#
#P#####P#P#####P#
#PPPPPPPPPPPPPPP#
#################
1
5
