#################
#PPPPPPP#PPPPPPP#
#P##P##P#P##P##P#
#HPPPPPP#PPPPPPH#
#P##P#PPPPP#P##P#
#PPPP#P###P#PPPP#
####P#PP#PP#P####
####P##P#P##P####
####P#PP#PP#P####
#1PPPPP..GPPPPP1#
####P#P...P#P####
####P#PSPPP#P####
####P#P###P#P####
#PPPPPPP#PPPPPPP#
#P##P##P#P##P##P#
#HP#PPPP.PPPP#PH#
##P#PP#####PP#P##
##P#PPPP#PPPP#P##
#PPPP#PP#PP#PPPP#
#P#####P#P#####P#
#PPPPPPPPPPPPPPP#
#################
