#################
#PPPPPPP#PPPPPPP#
#P##P##P#P##P##P#
#HPPPPPP#PPPPPPH#
#P##PPPPGPPPP##P#
#PPPPPPPPPPPPPPP#
####P#PPPPP#P####
####P#PPPPP#P####
####P#PPPPP#P####
#OPPP#PPPPP#PPPO#
####P#PPPPP#P####
####P#PPPPP#P####
####P#PPPPP#P####
#PPPPPPPPPPPPPPP#
#P##PPPPPPPPP##P#
#HP#PPPPSPPPP#PH#
##P#PP#####PP#P##
##P#PPPP#PPPP#P##
#PPPP#PP#PP#PPPP#
#P#####P#P#####P#
#PPPPPPPPPPPPPPP#
#################
9
9
